
NO textures/snk/mur1.xpm
SO  textures/snk/mur2.xpm
R 1280 720			
WE textures/snk/mur2.xpm
EA textures/snk/mur1.xpm

#S textures/Rick_Sanchez.xpm
S textures/snk/sprite.xpm
F 255,100,0
C 225,30,0

#111111111111111111111
#10000010010000010S001
#101000010010000000101
#101000010010011111101
#101000000000000000101
#101111110000000000101
#100000010100000000101
#111000010000000000101
#101111111111011110101
#101110000000000100001
#100011111111111111111
#10001
#10001
#10001
#11111

111111111111111111111111111111111
100010100000000000000000000000001
100000000000000000000002000000001
100000000000000000000000000000001
1E0000000000000000000000000000001
100000000000000000000000000000001
111111111111111111111111111111111
