
NO textures/pierre.xpm
SO  textures/NO_wood.xpm
R 1280 720											
WE textures/NO_wood.xpm
EA textures/pierre.xpm

S textures/Rick_Sanchez.xpm
F 300,100,0
C 225,30,0

#111111111111111111111
#10000010010000010S001
#101000010010000000101
#101000010010011111101
#101000000000000000101
#101111110000000000101
#100000010100000000101
#111000010000000000101
#101111111111011110101
#101110000000000100001
#100011111111111111111
#10001
#10001
#10001
#11111

11111111111111111
10000000S00000001
10000000000000001
10000000000000001
10000000000000001
10000000000000001
10000000200000001
10000000000000001
10000000000000001
10000000000000001
10000000000000001
11111111111111111
