
NO ./textures/snk/mur1.xpm
SO  ./textures/snk/mur2.xpm
R 10000 10000
                                 WE ./textures/snk/mur2.xpm
EA textures/snk/mur1.xpm

#S         textures/Rick_Sanchez.xpm
S textures/snk/sprite.xpm
F 0,0,0
C 225,30,0

#111111111111111111111
#10000010010000010S001
#101000010010000000101
#101000010010011111101
#101000000000000000101
#101111110000000000101
#100000010100000000101
#111000010000000000101
#101111111111011110101
#101110000000000100001
#100011111111111111111
#10001
#10001
#10001
#11111



#1111111111111111111111111111111111111111111111111111111111111111111111
#1000000000000000000000000000000000000000000000000000000000000000000001
#1000000000000000000000000000000000000000000000000000000000000000000001
#1000000000000000000000000000000000000000000000000000000000000000000001
#1000000000000000000000000000000000000000000000000000000000000000000001
#1000000000000000000000000000000000000000000000000000000000000000000001
#1000000000000000000000000000000000000000000000000000000000000000000001
#1000000000200000000000000000000000000000000000000000000000000000000001
#1000000000000000000000000000000000000000000000000000000000000000000001
#1000000000000000000000000000000000000000000000000000000000000000000001
#1000000000000000000000000000000000000000000000000000000000000000000001
#1000000000000000000000000000000000000000000000000000000000000000000001
#1000000000000000000000000000000000000000000000000000000000000000000001
#1000000000000000000000000000000000000000000000000000000000000000000001
#1000000000000000000000000000000000000000000000000000000000000000000001
#1000000000000000000000000000000000000000000000000000000000000000000001
#1000000000000000000000000000000000000000000000000000000000000000000001
#1000000000000000000000000000000000000000000000000000000000000000000001
#1000000000000000000000000000000000000000000000000000000000000000000001
#1000000000000000000000000000000000000000000000000000000000000000000001
#1000000000000000000000000000000000000000000000000000000000000000000001
#1000000000000000000000000000000000000000000000000000000000000000000001
#1000000000000000000000000000000000000000000000000000000000000000000001
#1000000000000000000000000000000000000000000000000000000000000000000001
#1000000000000000000000000000000000000000000000000000000000000000000001
#1000000000000000000000000000000000000000000000000000000000000000000001
#1000000000000000000000000000000000000000000000000000000000000000000001
#1000000000000000000000000000000000000000000000000000000000000000000001
#1000000000000000000000000000000000000000000000000000000000000000000001
#1000000000000000000000000000000000000000000000000000000000000000000001
#1000000000000000000000000000000000000000000000000000000000000000000001
#1000000000000000000000000000000000000000000000000000000002000000000001
#1000000000000000000000000000000000000000000000000000000000000000000001
#1000000000000000000000000000000000000000000000000000000000000000000001
#1000000000000000000000000000000000000000000000000000000000000000000001
#1000000000000000000000000000000000000000000000000000000000000000000001
#1000000000000000000000000000000000000000000000000000000000000000000001
#1000000000000000000000000000000000000000000000000000000000000000000001
#1000000000000000000000000000000000000000000000000000000000000000000001
#1000000000000000000000000000000000000000000000000000000000000000000001
#1000000000000000000000000000000000000000000000000000000000000000000001
#100000000000000000000000000000000S000000000000000000000000000000000001
#1000000000000000000000000000000000000000000000000000000000000000000001
#1000000000000000000000000000000000000000000000000000000000000000000001
#1000000000000000000000000000000000002000000000000000000000000000000001
#1000000000000000000000000000000000000000000000000000000000000000000001
#1000000000000000000000000000000000000000000000000000000000000000000001
#1000000000000000000000000000000000000000000000000000000000000000000001
#1000000000000000000000000000000000000000000000000000000000000000000001
#1000000000200000000000000000000000000000000000000000000000000000000001
#1000000000000000000000000000000000000000000000000000000000000000000001
#1000000000000000000000000000000000000000000000000000000000000000000001
#1000000000000000000000000000000000000000000000000000000000000000000001
#1000000000000000000000000000000000000000000002000000000000000000000001
#1000000000000000000000000000000000000000000000000000000000000000000001
#1000000000000000000000000000000000000000000000000000000000000000000001
#1000000000000000000000000000000000000000000000000000000000000000000001
#1000000000000000000000000000000000000000000000000000000000000000000001
#1000000000000000000000000000000000000000000000000000000000000000000001
#1000000000000000000000000000000000000000000000000000000000000000000001
#1000000000000000000000000000000000000000000000000000000000000000000001
#1000000000000000000000000000000000000000000000000000000000000000000001
#1000000000000000000000000000000000000000000000000000000000000000000001
#1000000000000000000000000000000000000000000000000000000000000000000001
#1000000000000000000000000000000000000000000000000000000000000000000001
#1000000000000000000000000000000000000000000000000000000000000000000001
#1000000000000000000000000000000000000000000000000000000000000000000001
#1000000000000000000000000000000000000000000000000000000000000000000001
#1000000000000000000000000000000000000000000000000000000000000000000001
#1000000000000000000000000000000000000000000000000000000000000000000001
#1000000000000000000000000000000000000000000000000000000000000000000001
#1000000000000000000000000000000000000000000000000000000000000000000001
#1000000000000000000000000000000000000000000000000000000000000000000001
#1000000000000000000000000000000000000000000000000000000000000000000001
#1000000000000000000000000000000000000000000000000000000000000000000001
#1000000000000000000000000000000000000000000000000000002000000000000001
#1000000000000000000000000000000000000000000000000000000000000000000001
#1000000000000000000000000000000000000000000000000000000000000000000001
#1000000000000000000000000000000000000000000000000000000000000000000001
#1000000000000000000000000000000000000000000000000000000000000000000001
#1000000000000000000000000000000000000000000000000000000000000000000001
#1111111111111111111111111111111111111111111111111111111111111111111111


#111111111
#100000001
#102100001
#10000000111
#11110000021
#10S01000101
#10001000121
#10001000101
#10000000101
#10000000121
#10000000101
#11111111121
#12002200201
#11111111111

11111111111111111111111
10000000000000000000001
10111111011111111111101
10100010010000010S00101
10101001001000000010101
10100101001001111100101
12100100000000000010101
11110011000000000010101
10000001010000000010101
10000001000000000010101
10011110111101111010101
11010000000000010000001
11011101111111101111101
10000100000000000000001
10001111111111111111111
10001
11111
