R 1280 720
NO ./textures/snk/mur1.xpm
SO ./textures/snk/wall.xpm
WE ./textures/snk/wall.xpm
EA ./textures/snk/wall.xpm
S ./textures/Rick_Sanchez.xpm
F 0000000,0,0
C 20,20,30


111111111
100000021
102100001
10000000111
11111000021
10S01000101
10001000121
10001000101
10000000121
10000000101
10200200101
11111111101
1F222222221
11111111111
