NO ./textures/snk/wall.xpm
SO  ./textures/snk/wall.xpm
WE ./textures/snk/mur1.xpm
EA ./textures/snk/wall.xpm

#S         textures/Rick_Sanchez.xpm
S textures/snk/sprite.xpm
F 0000000,0,0
C 20,20,30
R 1080 720

#111111111111111111111
#10000010010000010S001
#101000010010000000101
#101000010010011111101
#101000000000000000101
#101111110000000000101
#100000010100000000101
#111000010000000000101
#101111111111011110101
#101110000000000100001
#100011111111111111111
#10001
#10001
#10001
#11111



#1111111111111111111111111111111111111111111111111111111111111111111111
#1000000000000000000000000000000000000000000000000000000000000000000001
#1000000000000000000000000000000000000000000000000000000000000000000001
#1000000000000000000000000000000000000000000000000000000000000000000001
#1000000000000000000000000000000000000000000000000000000000000000000001
#1000000000000000000000000000000000000000000000000000000000000000000001
#1000000000000000000000000000000000000000000000000000000000000000000001
#1000000000200000000000000000000000000000000000000000000000000000000001
#1000000000000000000000000000000000000000000000000000000000000000000001
#1000000000000000000000000000000000000000000000000000000000000000000001
#1000000000000000000000000000000000000000000000000000000000000000000001
#1000000000000000000000000000000000000000000000000000000000000000000001
#1000000000000000000000000000000000000000000000000000000000000000000001
#1000000000000000000000000000000000000000000000000000000000000000000001
#1000000000000000000000000000000000000000000000000000000000000000000001
#1000000000000000000000000000000000000000000000000000000000000000000001
#1000000000000000000000000000000000000000000000000000000000000000000001
#1000000000000000000000000000000000000000000000000000000000000000000001
#1000000000000000000000000000000000000000000000000000000000000000000001
#1000000000000000000000000000000000000000000000000000000000000000000001
#1000000000000000000000000000000000000000000000000000000000000000000001
#1000000000000000000000000000000000000000000000000000000000000000000001
#1000000000000000000000000000000000000000000000000000000000000000000001
#1000000000000000000000000000000000000000000000000000000000000000000001
#1000000000000000000000000000000000000000000000000000000000000000000001
#1000000000000000000000000000000000000000000000000000000000000000000001
#1000000000000000000000000000000000000000000000000000000000000000000001
#1000000000000000000000000000000000000000000000000000000000000000000001
#1000000000000000000000000000000000000000000000000000000000000000000001
#1000000000000000000000000000000000000000000000000000000000000000000001
#1000000000000000000000000000000000000000000000000000000000000000000001
#1000000000000000000000000000000000000000000000000000000002000000000001
#1000000000000000000000000000000000000000000000000000000000000000000001
#1000000000000000000000000000000000000000000000000000000000000000000001
#1000000000000000000000000000000000000000000000000000000000000000000001
#1000000000000000000000000000000000000000000000000000000000000000000001
#1000000000000000000000000000000000000000000000000000000000000000000001
#1000000000000000000000000000000000000000000000000000000000000000000001
#1000000000000000000000000000000000000000000000000000000000000000000001
#1000000000000000000000000000000000000000000000000000000000000000000001
#1000000000000000000000000000000000000000000000000000000000000000000001
#100000000000000000000000000000000S000000000000000000000000000000000001
#1000000000000000000000000000000000000000000000000000000000000000000001
#1000000000000000000000000000000000000000000000000000000000000000000001
#1000000000000000000000000000000000002000000000000000000000000000000001
#1000000000000000000000000000000000000000000000000000000000000000000001
#1000000000000000000000000000000000000000000000000000000000000000000001
#1000000000000000000000000000000000000000000000000000000000000000000001
#1000000000000000000000000000000000000000000000000000000000000000000001
#1000000000200000000000000000000000000000000000000000000000000000000001
#1000000000000000000000000000000000000000000000000000000000000000000001
#1000000000000000000000000000000000000000000000000000000000000000000001
#1000000000000000000000000000000000000000000000000000000000000000000001
#1000000000000000000000000000000000000000000002000000000000000000000001
#1000000000000000000000000000000000000000000000000000000000000000000001
#1000000000000000000000000000000000000000000000000000000000000000000001
#1000000000000000000000000000000000000000000000000000000000000000000001
#1000000000000000000000000000000000000000000000000000000000000000000001
#1000000000000000000000000000000000000000000000000000000000000000000001
#1000000000000000000000000000000000000000000000000000000000000000000001
#1000000000000000000000000000000000000000000000000000000000000000000001
#1000000000000000000000000000000000000000000000000000000000000000000001
#1000000000000000000000000000000000000000000000000000000000000000000001
#1000000000000000000000000000000000000000000000000000000000000000000001
#1000000000000000000000000000000000000000000000000000000000000000000001
#1000000000000000000000000000000000000000000000000000000000000000000001
#1000000000000000000000000000000000000000000000000000000000000000000001
#1000000000000000000000000000000000000000000000000000000000000000000001
#1000000000000000000000000000000000000000000000000000000000000000000001
#1000000000000000000000000000000000000000000000000000000000000000000001
#1000000000000000000000000000000000000000000000000000000000000000000001
#1000000000000000000000000000000000000000000000000000000000000000000001
#1000000000000000000000000000000000000000000000000000000000000000000001
#1000000000000000000000000000000000000000000000000000000000000000000001
#1000000000000000000000000000000000000000000000000000000000000000000001
#1000000000000000000000000000000000000000000000000000002000000000000001
#1000000000000000000000000000000000000000000000000000000000000000000001
#1000000000000000000000000000000000000000000000000000000000000000000001
#1000000000000000000000000000000000000000000000000000000000000000000001
#1000000000000000000000000000000000000000000000000000000000000000000001
#1000000000000000000000000000000000000000000000000000000000000000000001
#1111111111111111111111111111111111111111111111111111111111111111111111
000
012

0111111111
0100000021
0102100001
010000000111
011111000021
010S01000101
010001000121
010001000101
010000000121
010000000101
010200200101
011111111101
01F222222221
011111111111
# 111111111111111111111111
#1100000000000000000001
#1011011111101111111111111111101
#10100010010000010S001000011
#10101001001000000010101111
#10100101001001111100101
#12100100000000000010101
#11110011000000000010101
#10000001010000000010101
#10000001000000000010101
#10011110111101111010101
#11010000000000010000001
#11011101111111101111101
#10000100000000000000001
#10001111111111111111111
#100000000001
#111110000001
#    11111111
#    1111
#        1111111111111111111111111
#        1000000000110000000000001
#        1011000001110000002000001
#        1001000000000000000000001
#111111111011000001110000000000001
#100000000011000001110111110111111
#11110111111111011100000010001
#11110111111111011101010010001
#11000000110101011100000010001
#10002000000000001100000010001
#10000000000000001101010010001
#11000001110101011111011110N0111
#1111F111 1110101 101111010001
#11111111 1111111 111111111111