R 1280 720
NO ./images/mur_N.xpm
SO ./images/mur_S.xpm
WE ./images/mur_W.xpm
EA ./images/mur_E.xpm
S      ./images/food.xpm       



F     120    ,     120    ,     120        
C  47 , 79   ,    79
11111111111111111111111111111  111
1000000000110200000000100000111101
1011000001110000000000101000100001
1001000000000000E00000101002111111
10110000011100000000000000001
10000000001100000111011110001
111101111111110111000000102011111
111101111111110111010100100011111
11000000110101011100000010201
10000000000000001100000010001
10000000000000001101010010001
11000000110101011111011110001
11110111111101011111011110001
11111111111111111111111110001
                        10001
          1111          10001
          1001          10001111
          1111          10000001
                        11111111


         111111
         100001
         111111

