R 1280 720
SO ./textures/snk/wall.xpm
  WE textures/snk/wall.xpm
EA ./textures/snk/wall.xpm
S ./textures/Rick_Sanchez.xpm
NO ./textures/snk/mur1.xpm

F 255, 0,0
C 20,20,30


111111111111111111111111111111111111111111111111
100000000000000000000000000000000000000100000F21
100000000000000000000000000000000000000102100001111
100000000000000000000000000000000000000100000001101
100000000000000000000000000000000000000111110000211
10000000000000000000000000000000000000010001000101
10000000000000000000000000000000000000010001000121
10000000000000000000000000000000000000010001000101
10000000000000000000000000000000000000010000000121
1000000000000000000000000N000000000000010000000101
10000000000000000000000000000000000000010200200101
10000000000000000000000000000000000000011111111101
10000000000000000000000000000000000000010222222221
100000000000000000000000000000000000000111111111110
111111111111111111111111111111111111111