R 500 500

NO ./textures/snk/mur1.xpm
SO  ./textures/snk/wall.xpm
WE ./textures/snk/wall.xpm
EA ./textures/snk/wall.xpm

#S         textures/Rick_Sanchez.xpm
S textures/snk/sprite.xpm
F 0000000,0,0
C 20,20,30

#111111111111111111111
#10000010010000010S001
#101000010010000000101
#101000010010011111101
#101000000000000000101
#101111110000000000101
#100000010100000000101
#111000010000000000101
#101111111111011110101
#101110000000000100001
#100011111111111111111
#10001
#10001
#10001
#11111



#1111111111111111111111111111111111111111111111111111111111111111111111
#1000000000000000000000000000000000000000000000000000000000000000000001
#1000000000000000000000000000000000000000000000000000000000000000000001
#1000000000000000000000000000000000000000000000000000000000000000000001
#1000000000000000000000000000000000000000000000000000000000000000000001
#1000000000000000000000000000000000000000000000000000000000000000000001
#1000000000000000000000000000000000000000000000000000000000000000000001
#1000000000200000000000000000000000000000000000000000000000000000000001
#1000000000000000000000000000000000000000000000000000000000000000000001
#1000000000000000000000000000000000000000000000000000000000000000000001
#1000000000000000000000000000000000000000000000000000000000000000000001
#1000000000000000000000000000000000000000000000000000000000000000000001
#1000000000000000000000000000000000000000000000000000000000000000000001
#1000000000000000000000000000000000000000000000000000000000000000000001
#1000000000000000000000000000000000000000000000000000000000000000000001
#1000000000000000000000000000000000000000000000000000000000000000000001
#1000000000000000000000000000000000000000000000000000000000000000000001
#1000000000000000000000000000000000000000000000000000000000000000000001
#1000000000000000000000000000000000000000000000000000000000000000000001
#1000000000000000000000000000000000000000000000000000000000000000000001
#1000000000000000000000000000000000000000000000000000000000000000000001
#1000000000000000000000000000000000000000000000000000000000000000000001
#1000000000000000000000000000000000000000000000000000000000000000000001
#1000000000000000000000000000000000000000000000000000000000000000000001
#1000000000000000000000000000000000000000000000000000000000000000000001
#1000000000000000000000000000000000000000000000000000000000000000000001
#1000000000000000000000000000000000000000000000000000000000000000000001
#1000000000000000000000000000000000000000000000000000000000000000000001
#1000000000000000000000000000000000000000000000000000000000000000000001
#1000000000000000000000000000000000000000000000000000000000000000000001
#1000000000000000000000000000000000000000000000000000000000000000000001
#1000000000000000000000000000000000000000000000000000000002000000000001
#1000000000000000000000000000000000000000000000000000000000000000000001
#1000000000000000000000000000000000000000000000000000000000000000000001
#1000000000000000000000000000000000000000000000000000000000000000000001
#1000000000000000000000000000000000000000000000000000000000000000000001
#1000000000000000000000000000000000000000000000000000000000000000000001
#1000000000000000000000000000000000000000000000000000000000000000000001
#1000000000000000000000000000000000000000000000000000000000000000000001
#1000000000000000000000000000000000000000000000000000000000000000000001
#1000000000000000000000000000000000000000000000000000000000000000000001
#100000000000000000000000000000000S000000000000000000000000000000000001
#1000000000000000000000000000000000000000000000000000000000000000000001
#1000000000000000000000000000000000000000000000000000000000000000000001
#1000000000000000000000000000000000002000000000000000000000000000000001
#1000000000000000000000000000000000000000000000000000000000000000000001
#1000000000000000000000000000000000000000000000000000000000000000000001
#1000000000000000000000000000000000000000000000000000000000000000000001
#1000000000000000000000000000000000000000000000000000000000000000000001
#1000000000200000000000000000000000000000000000000000000000000000000001
#1000000000000000000000000000000000000000000000000000000000000000000001
#1000000000000000000000000000000000000000000000000000000000000000000001
#1000000000000000000000000000000000000000000000000000000000000000000001
#1000000000000000000000000000000000000000000002000000000000000000000001
#1000000000000000000000000000000000000000000000000000000000000000000001
#1000000000000000000000000000000000000000000000000000000000000000000001
#1000000000000000000000000000000000000000000000000000000000000000000001
#1000000000000000000000000000000000000000000000000000000000000000000001
#1000000000000000000000000000000000000000000000000000000000000000000001
#1000000000000000000000000000000000000000000000000000000000000000000001
#1000000000000000000000000000000000000000000000000000000000000000000001
#1000000000000000000000000000000000000000000000000000000000000000000001
#1000000000000000000000000000000000000000000000000000000000000000000001
#1000000000000000000000000000000000000000000000000000000000000000000001
#1000000000000000000000000000000000000000000000000000000000000000000001
#1000000000000000000000000000000000000000000000000000000000000000000001
#1000000000000000000000000000000000000000000000000000000000000000000001
#1000000000000000000000000000000000000000000000000000000000000000000001
#1000000000000000000000000000000000000000000000000000000000000000000001
#1000000000000000000000000000000000000000000000000000000000000000000001
#1000000000000000000000000000000000000000000000000000000000000000000001
#1000000000000000000000000000000000000000000000000000000000000000000001
#1000000000000000000000000000000000000000000000000000000000000000000001
#1000000000000000000000000000000000000000000000000000000000000000000001
#1000000000000000000000000000000000000000000000000000000000000000000001
#1000000000000000000000000000000000000000000000000000002000000000000001
#1000000000000000000000000000000000000000000000000000000000000000000001
#1000000000000000000000000000000000000000000000000000000000000000000001
#1000000000000000000000000000000000000000000000000000000000000000000001
#1000000000000000000000000000000000000000000000000000000000000000000001
#1000000000000000000000000000000000000000000000000000000000000000000001
#1111111111111111111111111111111111111111111111111111111111111111111111


12

111111111
100000021
102100001
10000000111
11111000021
10S01000101
10001000121
10001000101
10000000121
10000000101
10000200101
11111111101
1F222222221
11111111111


#0
#01111111111111111111111
#01100000000000000000001
#01011011111101111111111111111101
#010100010010000010S001000011
#010101001001000000010101111
#010100101001001111100101
#012100100000000000010101
#011110011000000000010101
#010000001010000000010101
#010000001000000000010101
#010011110111101111010101
#011010000000000010000001
#011011101111111101111101
#010000100000000000000001
#010001111111111111111111
#0100000000001
#0111110000001
#0    11111111
#0    1111
#        1111111111111111111111111
#        1000000000110000000000001
#        1011000001110000002000001
#        1001000000000000000000001
#111111111011000001110000000000001
#100000000011000001110111110111111
#11110111111111011100000010001
#11110111111111011101010010001
#11000000110101011100000010001
#10002000000000001100000010001
#10000000000000001101010010001
#11000001110101011111011110N0111
#1111F111 1110101 101111010001
#11111111 1111111 111111111111