R 1280 720
NO ./textures/snk/wall.xpm
SO  ./textures/snk/wall.xpm
WE ./textures/snk/wall.xpm
EA ./textures/snk/wall.xpm

S textures/Rick_Sanchez.xpm
F 0,0,0
C 20,20,30
01
0
011111111111111111111111
010000000000000000000001
010111111111111111111101
010100012012000010S00101
010101001001000000010101
010100101001001111100101
010100100000000000210101
010111101000002000010101
01010000101000000001010100000100000
010101001000000000010101
012001000111101111010100
011001000000000210020101
011111111111111101111101
010000000000000000000001
012221111111111111111111
010F01
011111
0
