R 1920 1080

NO ./textures/snk/mur1.xpm
SO  ./textures/snk/wall.xpm
WE ./textures/snk/wall.xpm
EA ./textures/snk/wall.xpm

S textures/snk/sprite.xpm
F 0000000,0,0
C 20,20,30

0
         1111111111111111111111111
         1000000000110000000000001
         1011000001110000002000001
         1001000000000000000000001
01111111110110000011100000000000010
0100000000011000001110111110111111
011110111111111011100000010001
011110111111111011101010010001
011000000110101011100000010001
010002000000000001100000010001
010000000000000001101010010001
011000001110101011111011110N0111
01111F111 1110101 101111010001
011111111 1111111 111111111111
0